00000000
00000000
00000022
00002220
00000200
00022220
00022000
00000000
